1111111111111111111111111111111111
1E1000000000000C00000C000000000001
1000010100100000101001000000010101
1000010011101010001001000000010101
1P1000001C10C0000000000000000000C1
1111111111111111111111111111111111