11111111111111111111111111111111
10LL0000000000001100010000000001
1000000000000E10000000000C000001
1000000000001PC10000L00000000001
10000000000001100000011100000001
10C000011100000000L0000000000001
10000000000000000000000001000001
11111111111111111111111111111111