1111111111101111111111
0000000000000000000000
1111111111101111111111