1111111111111111111111111111111111
1E00000000000000000000000000000001
1010010100100000101001000000010101
1010010010101010001001000000010101
1PB00000000101000C0000000000000001
1111111111111111111111111111111111